###################
#####---###########
#####o--###########
#####--o###########
###--o-o-##########
###-#-##-##########
#---#-##-#####--xx#
#-o--o----------xx#
#####-###-#s##--xx#
#####-----#########
####################