##############
#xx--#-----###
#xx--#-o--o--#
#xx--#o####--#
#xx----s-##--#
#xx--#-#--o-##
######-##o-o-#
###-o--o-o-o-#
###----#-----#
###############