#################
#########-----s##
#########-o#o-###
#########-o--o###
##########o-o-###
#########-o-#-###
#xxxx--##-o--o--#
#xxxx----o--o---#
#xxxx--##########
##################