###################
############--xxxx#
############--xxxx#
#----#--o-o---xxxx#
#-ooo#o--o-#--xxxx#
#--o-----o-#--xxxx#
#-oo-#o-o-o########
#--o-#-----########
##-################
#----#----#########
#-----o---#########
#--oo#oo--s########
#----#----#########
####################