#################
#########---#####
#########-#o##--#
#########-----o-#
#########-###---#
#xxxx--##-o--o###
#xxxx----o-oo-###
#xxxx--##o--o-s##
#########--o--###
#########-o-o--##
###########-##-##
###########----##
##################