#############
########---##
##-#-s##-oo-#
#----o------#
#--o--###---#
###-#####o###
#-o--###-xx##
#-o-o-o-xxx##
#----###xxx##
#-oo-###xxx##
#--##########
#############