################
###--###########
###----o---o-o-#
###-o#-o-#--o--#
###--o-o--#----#
###-o#-#--####-#
#s#o-o-o--##---#
#----o-#o#---#-#
#---o----o-o-o-#
#####--#########
###------#######
###------#######
###xxxxxx#######
###xxxxxx#######
###xxxxxx#######
#################