########
#----x-#
#--o---#
#-s----#
#########