#############
#--s--#--x--#
#-----#-----#
#-----#-----#
#--o--#-----#
#-----------#
##############